.................................
..@..............................
.................................
...............########..........
..................##.............
..................##.............
..................##.............
.................................
.................................